101-101-2
102-2-101
103-107-2
104-2-107
105-109-2
106-2-109
107-108-2
108-2-108
109-102-2
110-2-102
111-103-2
112-2-103
113-104-2
114-2-104
115-105-2
116-2-105
119-106-2
120-2-106
121-110-2
122-2-110
123-111-2
124-2-111
125-112-2
126-2-112
151-151-2
152-2-151
153-152-2
154-2-152
155-153-2
156-2-153
157-154-2
158-2-154
159-155-2
160-2-155
161-156-2
162-2-156
163-157-2
164-2-157
165-158-2
166-2-158
167-159-2
168-2-159
169-160-2
170-2-160
301-301-2
302-2-301
303-302-2
304-2-302
305-303-2
306-2-303
201-201-2
202-2-201
203-202-2
204-2-202
205-203-2
206-2-203
207-204-2
208-2-204
209-205-2
210-2-205
211-206-2
212-2-206
213-207-2
214-2-207
215-208-2
216-2-208
217-209-2
218-2-209
